5 9
000010000
000111000
001111100
011111110
111111111
